R 1920                   1080



NO ./src/snoopy.xpm

			SO ./src/Ice_cube.xpm
WE ./src/Kanyeee.xpm
EA ./src/trump.xpm
S ./src/dance_baloon.xpm
F 			200,100,240





C                122,200,200  
1111111111111111111111111
1000000000110000000000001
1011000001110000002000001
100100000000001000000000111111111
111111111011000001110000000000001
100000000011000001110111110111111
11110111111111011100000010001
11110111111111011101010010001
11000000110101011100000010001
10002000000000001100000010001
10000000000000001101010010001
11000001110101011111011112W2111
11110111 1110101 101111010001 
11111111 1111111 111111111111